25 19
.........................
...BBBB...B..B...BBBBB...
...B..B...B..B.....B.....
...B..B...B..B.....B.....
...B..B...B..B.....B.....
...BBBB...BBBB.....B.....
.........................
.........................
.........................
.........................
.........................
.........................
.........................
.........................
.........................
.........................
.........................
.........................
.........................